OOOOOOOOOOOOOO
OOOOOOOOOOOOOO
OOBBBBBBBBBOOO
OOBGGGGGGGBOOO
OOBGGGGGGGBOOO
OOBGGGGGGGBOOO
OOBGGGGGGGBOOO
OOBGGGGGGGBOOO
OOBGGGGGGGBOOO
OOBGGGGGGGBOOO
OOBGGGGGGGBOOO
OOBBBBBBBBBOOO
OOOOOOOOOOOOOO
OOOOOOOOOOOOOO