OOOOOOOOOOOOOO
OOOOOOOOOOOOOO
OOBBBOOBBBBOOO
OOBBBOOBBBBOOO
OOBBBBBBBBBOOO
OOBBBBBBBBBOOO
OOBBBBBBBBBOOO
OOBBBBBBBBBOOO
OOBBBBBBBBBOOO
OOBBBBBBBBBOOO
OOBBBBBBBBBOOO
OOBBBBBBBBBOOO
OOOOOOOOOOOOOO
OOOOOOOOOOOOOO