EEEEEEEEEEEE
EFFFFFFFFFFE
EFFFFFFWFFFE
EFFFFFFFFFFE
EFFFFFFFFFFE
EFFFFFFFFFFE
EFFFFFFFFFFE
EFWWFWWFFFFE
EFWFFFWFFFFE
EFWFWFWFFFFE
EFWFFFWFFFFE
EEWWWWWEEEEE