EEEEEEEEEEEE
EFFFFFFFFFFE
EFFFFFFFFFFE
EFFFFFFFFFFE
EFFFFFFFFFFE
EFFFFFFFFFFE
EFFFFFFFFFFE
EFFFFWFFFFFE
EFFFFWFFFFFE
EFWWWWFFFFFE
EFFFFFFFFFFE
EEEEEEEEEEEE